6 6
######
#K...#
##.#.#
#.#..#
#.P..#
######

