10 10
##########
#.#.....P#
#K#......#
#.#......#
#.#......#
#.#.....Z#
#..ZZZZZZ#
#.#.....Z#
#.#......#
##########